XXXXXXXXXXXX
X...X2.X.s.X
X.X....X.XXX
X..X.X.X.X.X
XX.XXX.X.s.X
X....s...X.X
XsXX2..X..1X
XXXXXXXXXXXX
