..............
....XXXXX.....
..............
..............
s.............
....XXXXX.....
..............
..............
..............
..........e...
....XXXXX.....
..............
..............
..............
....XXXXX.....
..............
..............
..............
..........e...
....XXXXX.....
..............
..............
..............
....XXXXX.....
..............
..............
..............
..........e...
....XXXXX.....
..............
..............
..............
....XXXXX.....
..............
..............
..............
..........e...
....XXXXX.....
..............
..............
..............
....XXXXX.....
..............
..............
..............
..............
..............
..............
..............
..............
..............
..............
..............
..............
..............
..............
..............
..............
..............
..............
..............
..............
..............
..............
..............
..............
..............
..............
..............
..............