XXXXXXXXXXXX
X...Xe.X...X
X.X....X.XXX
X..X.X.X.X.X
XX.XXX.X...X
X........X.X
XsXXe..X..eX
XXXXXXXXXXXX

