.............
.............
....XXXXXs...
.............
.e...........