.............
..........e..
....XXXXX....
.............
.............
s............
....XXXXX....
.............
.............