XXXXXXXXXXXX
X...X..Xe..X
X.X....X.XXX
X..X.X.X.X.X
XXXXXXXXXXXX
X........X.X
XsXX...X...X
XXXXXXXXXXXX